"0","0","9999"
"1","10000","19999"
"2","20000","29999"
"3","30000","39999"
"4","40000","49999"
"5","50000","59999"
"6","60000","69999"
"7","70000","79999"
"8","80000","89999"
"9","90000","99999"
"10","100000","149999"
"11","150000","199999"
"12","200000","249999"
"13","250000","0"
